{
 "tileset" : "/chemin.png",
 "terrain" : [
		[ 2,  2,  2,  2,  2,  2,  9, 11,  2,  2,  2,  2,  2,  2,  2,  3,  2,  2],
        [ 2,  2,  2,  2,  2,  2,  9, 10, 10, 10, 10, 10, 10, 10, 10,  3,  2,  2], 
        [ 8, 10, 14, 14, 14, 14, 10, 11,  2,  2,  2,  2, 10, 10,  2,  3,  2,  2],
        [ 8, 11,  2,  2,  2,  2,  9, 11,  2,  2,  2, 10, 10,  2,  2,  3,  2,  2],
        [ 8, 11,  2,  2,  2,  2,  9, 11,  2,  2, 10, 10,  2,  2,  2,  3,  2,  2],
        [ 8, 11,  2, 17,  2,  2,  9, 11,  2, 10, 10,  2,  2,  2,  2,  3,  2,  2],
        [ 8, 11,  2,  2,  2,  2,  9, 10, 10, 10,  2,  2,  2,  2,  2,  3,  2,  2],
        [ 8, 11,  2,  2,  2,  2,  9, 10, 10, 10,  6,  6,  6,  6, 10, 10, 10,  3],
        [ 8, 11,  2,  2,  2,  2,  9, 12, 14, 14, 14, 14, 14, 14, 10, 10, 10,  3],
        [ 8, 10,  6,  6,  6,  6, 10, 11, 17,  2,  2,  2,  2,  2,  8,  2,  2,  3],
        [14, 10, 14, 14, 14, 14, 16, 11,  2,  2,  2,  2,  2,  2,  8,  2,  2,  3],
        [ 2,  2,  2,  2,  2,  2,  9, 11,  2,  2,  2,  2,  2,  2,  8,  2,  2,  3],
        [ 2,  2,  2,  2,  2,  2,  9, 11,  2,  2,  2,  2, 18,  2,  8,  2,  2,  3],
        [ 2,  2,  2,  2,  2,  2,  9, 11,  2,  2,  2,  2,  2,  2,  8,  2,  2,  3],
        [ 2,  2,  2,  2,  2,  2,  9, 12,  6,  6,  6,  6,  6,  6, 12,  2,  2,  3],
	    [ 2,  2,  2,  2,  2,  2,  9, 11,  2,  2,  2,  2,  2,  2, 19,  2,  2,  3],
		[ 2,  2,  2,  2,  2,  2,  9, 11,  2,  2,  2,  2,  2,  2,  2,  2,  3,  3],
		[ 2,  2,  2,  2,  2,  2,  9, 10,  3,  3,  3,  3,  3,  3,  3,  3,  3,  2]
		]
}
